annex|anex|annx|anx|annexe
antenna|ant
apartment|apartement|apt|aprt|apparement|appartment
barbeque|bbq|barbecue
basement|bsm|bsmt|bsmnt|basement|bsment
berth|brth
block|blk|bl|blck
building|bdg|bldg|blg
bungalow|bongalow|bunglow|bungalo|bngw|bnglw
cabin|cabn
cage
caravan|cvan
carpark|carp
carspace|cars
club
cottage|ctg|ctge
department|dept
duplex|dup
extension|ext|extn
factory|fcty|fty|fy
farm|frm
flat|ft|fl|flt
garage|grge
ground floor|gd|gdfl|gd fl
hall
hangar|hngr
house|hous|hs|hse|ho
kiosk|ksk
lease|lse
lobby|lby|lbby
location|loc
lower|lwr
maisonette|msnt
marine berth|mb
number|#|nbr|num|no|nmbr|nr
office|ofc|off|offc
penthouse|pths|ph|pent house
portion|por
rear
reserve|rsve|rsrv|rsv
room|rm
section|sec
shed|shd
shop|shp
showroom|shrm
sign
site
space|spc
stall|stl|stll|sl
station
stop
store|stor
strata unit|su
studio|stu
substation|subs
suite|ste
tenancy|tncy
tower|twr
townhouse|tnhs
trailer|trlr
unit|un|unt
van
vault|vlt
villa|vlla|vl
ward|wrd|wd
warehouse|we|whs
workshop|wshp|wkshp|wksp